NO assets/wall1.xpm
SO assets/wall1.xpm
WE assets/wall1.xpm
EA assets/wall1.xpm
F 220,0,80
C 255,255,233


   11111111111111
111100010000000011111
100000000000000000011
1111100000N0000000001
    10000000000000011
    10000000000000001
111110000000111111111
100000010001
100000010001
100000010001
100000010001
100000010001
100000010001
100000010001
111111111111

