   NO assets/wall1.xpm

     WE    assets/wall1.xpm
EA    assets/wall1.xpm
    F    220,0,80
 C       255,255,233
    SO assets/wall1.xpm

11111111111111
100000100000011111111
100000000000000000001
111110000000000000001
    10000000000000001
    10000000000000001
111110000000111111111
100000010001
100000010001
100000010N01
111111111111

