NO assets/eagle.xpm
SO assets/eagle.xpm
WE assets/eagle.xpm
EA assets/eagle.xpm
F 220,0,80
C 255,255,233


   11111111111111
111100010000000011111
100000000000000000011
1111100000N0000000001
    10000000000000011                   11111111111
    10000000000000001                  1000000000001
111110000001111111111                  1000000000001
100000010001000000001111111            1000000000001
1000000100010000000000000001            10000000001
1000000100010000000000000001             100000001
1000000100010000000000000001              1111111
1000000100010000000000000001
100000010001111111111111111
100000010001
111111111111
100001
100001           11111
100001           10001
111111           11111
