NO assets/eagle.xpm
SO assets/eagle.xpm
WE assets/eagle.xpm
EA assets/eagle.xpm

F 220,0,80
C 255,255,233

111111111111111
100000000000001
10000011100000111111111111111111
10000010100000100000000000000001
10000011100000000000000000000001
10000000000000100000000000000001
10000000000000100000000000000001
11110111111101111111111111111111
101000000000001
100000000000001
101000000000001
101000111000001
1N1000000000001
111111111111111